011111111111111111111111
000000000000000000000001
011111111111111011111101
011111100000001011111101
011111101111111011000001
000000000000000011011011
110111101101111011011011
110111101101111011011011
110111101101000011011011
110111101101111111011011
110111101100000000011011
110000001101111111111011
111101111100000000001011
111101111111111111101000
111100000000000000001110
111111111111111111111110
